....................................................................................................................................................................................................................................................
....................................................................................................................................................................................................................................................
....................................................................................................................................................................................................................................................
....................................................................................................................................................................................................................................................
.................................................................................................................................PP.................................................................................................................
................................................................................................................................VPP.................................................................................................................
..............................................................................................................................LSSSSR................................................................................................................
............................................................................................................................P.....P.....PPPP.....P.....PPP..........................................................................................
.................................PP.................................................................................................................................................................................................................
...........................................................................................................................LSR...LSR...LSSSSR...LSR...LSSSSR........................................................................................
.................................LR.............PP..................................................................................................................................................................................................
.......................................................................................................................LSR.................................LSSR.....................................................................................
.............................PP...........LSSR..............................................PP......................................................................................................................................................
............................LSSR.................LSSR.....PP...............................................................LSR....................................TTTSSR......TTT...................................................................
.............P.....................LSSR...................................................TTTTTT..................................................................MMM.........MMMTTT.....................PPPP.......................................
............LSR........TTT................LSR...........TTT.........................LSR...MMMMMM.......................LSR...LSSTTT...PP..PP..PP............LSR...MMM......LSSMMMMMM...................LSSSSSSR.....................................
.......................MMM...............P..............MMM..........P.PP...............P.MMMMMMTT....................P.P.....P.MMM...............................MMM....PP...MMMMMMTTT........................................................F....
..I.................TTTMMM...............PPV............MMMTTT........V.........TTTT......MMMMMMMMTT...................V......P.MMM............................TTTMMM.V..PP...MMMMMMMMM.............V...............................................
TTTTTTTTTTTTTTTTTTTTMMMMMMTTTTTTTTTTTTTTTTTTTTTTTTTTTTTTMMMMMMTTTTTTTTTTTTTTTTTTMMMMTTTTTTMMMMMMMMMMTTTTTTTTTTTTTTTTTTTTTTTTTTTTMMMTTTTTTTTTTTTTTTTTTTTTTTTTTTTMMMMMMTTTTTTTTTMMMMMMMMMTTTTTTTTTTTTTTTTTTTTTTTTTTTTTTTTTTTTTTTTTTTTTTTTTTTTTTTTTTTTT
MMMMMMMMMMMMMMMMMMMMMMMMMMMMMMMMMMMMMMMMMMMMMMMMMMMMMMMMMMMMMMMMMMMMMMMMMMMMMMMMMMMMMMMMMMMMMMMMMMMMMMMMMMMMMMMMMMMMMMMMMMMMMMMMMMMMMMMMMMMMMMMMMMMMMMMMMMMMMMMMMMMMMMMMMMMMMMMMMMMMMMMMMMMMMMMMMMMMMMMMMMMMMMMMMMMMMMMMMMMMMMMMMMMMMMMMMMMMMMMMMMMM