....................................................................................................................................................................................................................................................
....................................................................................................................................................................................................................................................
......................................................................................................................................WW............................................................................................................
....................................................................................................................................................................................................................................................
.....................................................................................................................................LSSR...........................................................................................................
...............................................................................................................................V................V...................................................................................................
...........................................................................................................................LSSSSR...LSSSSR...LSSSSR..........W......................................................................................
.............................................W...............................................................................................................W......................................................................................
...................................................W............................................................W....LSR.........LSSSSTTSSSSR.........LSR...........................................................................................
............................................LSR..........W............................................................................MM....................LSR.....................................................................................
.................................W....TTT.........LSR..........W.....W..............................LR....W....LSR....................MM............................................................................................................
.................................W..V.MMM...............LSR..........W........................WW......................................MM..............LSR...........................................................................................
................................LSSSSSMMM..........V..........LSR.........LSR............WW.W.....LR.......TSR...............WWW....................................................................................................................
..................................................LSR...............TTT....................V.............MMM...........................................W....LSR......................WW.............................................................
....................................................................MMM.................LSSSSR...........MMMSSSSSR.......LSSSSSR....................................................................................................................
.......................LSSSSR...............LSR...WW..............W.MMMSSR...............................MMM......................WWW.MM..............LSR.......................LSSSSSSSSSSR........................................................
.................TTT.....W..W...TTTSSR............................W.MMM...W............WW.WW....................................W.....MM.......................................................................................................F....
..I..............MMM......V.WW..MMM.............V.....V........V....MMM..VW..........V........V...............WWWWW...............W.VMMMM..................V........WW..WW......V................................V...WWW.V..........................
TTTTTTTTTTTTTTTTTMMMTTTTTTTTTTTTMMMTTTTTTTTTTTTTTTTTTTTTTTTTTTTTTTTTMMMTTTTTTTTTTTTTTTTTTTTTTTTTTTTTTTTTTTTTTTTTTTTTTTTTTTTTTTTTTTTTTMMMMTTTTTTTTTTTTTTTTTTTTTTTTTTTTTTTTTTTTTTTTTTTTTTTTTTTTTTTTTTTTTTTTTTTTTTTTTTTTTTTTTTTTTTTTTTTTTTTTTTTTTTTTTTT
MMMMMMMMMMMMMMMMMMMMMMMMMMMMMMMMMMMMMMMMMMMMMMMMMMMMMMMMMMMMMMMMMMMMMMMMMMMMMMMMMMMMMMMMMMMMMMMMMMMMMMMMMMMMMMMMMMMMMMMMMMMMMMMMMMMMMMMMMMMMMMMMMMMMMMMMMMMMMMMMMMMMMMMMMMMMMMMMMMMMMMMMMMMMMMMMMMMMMMMMMMMMMMMMMMMMMMMMMMMMMMMMMMMMMMMMMMMMMMMMMMMM