....................................................................................................................................................................................................................................................
....................................................................................................................................................................................................................................................
....................................................................................................................................................................................................................................................
.................................................................................................GG..................................................GG..........VV.................................................................................
...............................................................................................LSSSSR......LSSSSR..................................LSSSSR......LSSSSR...............................................................................
....................................................................................................................................................................................................................................................
......................................................................................................G...G.........................................................................................................................................
.......................................................................G.G..G............................V............V......GGG.......................................................GG...........................................................
................................................V..VGGG................GV..VG.....TTTTTTTTTTTTTSSSSSSSSSSSSSSSSSSSSSSSSSSSSSSSSSSSSSR.......LSSSSSSSSSSSSSSSSSSSSSSSSSSSSSSSSSSSSSSSSSSSSSR.........................................................
..........................................TTTTTTTTTTTTTTTTTTTTTTTTTTSSSSSSSSSSSSSSMMMMMMMMMMMMM.....................................................................................................................................................
..............................V....V.GG.V.MMMMMMMMMMMMMMMMMMMMMMMMMM...................................................................TTT....................G.V.........V.G..............LSSSSR...................................................
.........................TTSSSSSSSSSSSSSSSMMMMMMMMMMMMMMMMMMMMMMMMMM................V..................................................MMM....................LSSSR..G..LSSSR.......................V...............................................
......................TTTMM......................................................LSSSSR.............................................TTTMMMTTT.G..................................................LSSSSR.............................................
......................MMMMM................G.G.........GG..........................................G........................V.......MMMMMMMMMTTT.....................V....................................G.........................................
...................TTTMM....................V........LSSSSR........V.......LSSSSR..................G..........LSSSSSR......TTTT..............MMMV........LSSSR.....LSSSR.....LSSSR.....................LSSSSR.......................................
...................MMMMM.................LSSSSR.................LSSSSR................G..LSR.......G..V..V...............GGMMMM..............MMMTTTTTT...............................TTTT...........................................................
................TTTMM.....G...........G............................................G.............TTTSSSSSSR.............TTTMMMMTTTGG........GMMMMMMMMM...............................MMMM....................LSSSSR............................F....
..I.............MMMMM...V.G...........GV............................................V.V...V......MMM.VV..GG.............MMMMMMMMMMTTT...VV..GMMMMMMMMMTTT......V.GG..V.GG.V.......TTTMMMMTTT........................V...............................
TTTTTTTTTTTTTTTTMMMMMTTTTTTTTTTTTTTTTTTTTTTTTTTTTTTTTTTTTTTTTTTTTTTTTTTTTTTTTTTTTTTTTTTTTTTTTTTTTMMMTTTTTTTTTTTTTTTTTTTTMMMMMMMMMMMMMTTTTTTTTMMMMMMMMMMMMTTTTTTTTTTTTTTTTTTTTTTTTTMMMMMMMMMMTTTTTTTTTTTTTTTTTTTTTTTTTTTTTTTTTTTTTTTTTTTTTTTTTTTTTTTT
MMMMMMMMMMMMMMMMMMMMMMMMMMMMMMMMMMMMMMMMMMMMMMMMMMMMMMMMMMMMMMMMMMMMMMMMMMMMMMMMMMMMMMMMMMMMMMMMMMMMMMMMMMMMMMMMMMMMMMMMMMMMMMMMMMMMMMMMMMMMMMMMMMMMMMMMMMMMMMMMMMMMMMMMMMMMMMMMMMMMMMMMMMMMMMMMMMMMMMMMMMMMMMMMMMMMMMMMMMMMMMMMMMMMMMMMMMMMMMMMMMMM